000 000 000 000 000 000 000 000 000 000 000 000 000 000 000 000 000 000 000 000
000 200 200 200 200 200 200 200 200 200 200 200 200 200 200 200 200 200 000 000
000 200 200 200 200 200 200 200 200 200 200 200 200 200 200 200 200 200 200 000
000 200 200 200 200 200 200 200 200 200 200 200 200 200 200 200 200 200 200 000
000 200 200 200 200 200 200 200 200 200 200 200 200 200 200 200 200 200 200 000           
000 200 200 200 200 200 200 200 200 200 200 200 200 200 200 200 200 200 200 000
000 200 200 200 200 200 200 200 200 200 200 200 200 200 200 200 200 200 200 000
000 200 200 200 200 200 200 200 200 200 200 200 200 200 200 200 200 200 200 000
000 200 200 200 200 200 200 200 200 200 200 200 200 200 200 200 200 200 200 000           
000 200 200 200 200 200 200 200 200 200 200 200 200 200 200 200 200 200 200 000
000 200 200 200 200 200 200 200 200 200 200 200 200 200 200 200 200 200 200 000
000 200 200 200 200 200 200 200 200 200 200 200 200 200 200 200 200 200 200 000
000 200 200 200 200 200 200 200 200 200 200 200 200 200 200 200 200 200 200 000           
000 200 000 000 000 000 000 200 000 000 200 200 200 200 200 200 200 200 200 000
000 200 200 200 200 200 000 200 200 000 200 200 200 200 200 200 200 200 200 000
000 200 200 200 200 200 000 200 200 000 200 200 200 200 200 200 200 200 200 000
000 200 200 200 200 200 000 200 200 000 200 200 200 200 200 200 200 200 200 000
000 200 200 200 200 200 000 200 200 000 200 200 200 200 200 200 200 200 200 000
000 200 200 200 200 200 000 200 200 000 200 200 200 200 200 200 200 200 200 000
000 000 000 000 000 000 000 000 000 000 000 000 000 000 000 000 000 000 000 000
