000 000 000 000 000 000 000 000 700 700 000 000 000 000 000 000 000 000 000 000
000 200 200 200 200 200 200 200 200 200 200 200 200 200 200 200 200 200 000 000
000 200 200 200 200 200 200 200 200 200 200 200 200 200 200 200 200 200 200 000
000 200 200 200 200 200 200 200 200 200 200 200 200 200 200 200 200 200 200 000
000 200 200 200 200 200 200 200 200 200 200 200 200 200 200 200 200 200 200 000           
000 200 200 200 200 200 200 200 200 200 200 200 200 200 200 200 200 200 200 000
000 200 200 200 200 200 200 200 200 200 200 200 200 200 200 200 200 200 200 000
000 200 200 200 200 200 200 200 200 200 200 200 200 200 200 200 200 200 200 000
000 200 200 200 200 200 200 200 200 200 200 200 200 200 200 200 200 200 200 000           
000 200 200 200 200 200 200 200 200 200 200 200 200 200 200 200 200 200 200 000
000 200 200 200 200 200 200 200 200 200 200 200 200 200 200 200 200 200 200 000
000 200 200 200 200 200 200 200 200 200 200 200 200 200 200 200 200 200 200 000
000 200 200 200 200 200 200 200 200 200 200 200 200 200 200 200 200 200 200 000           
000 200 000 000 000 000 000 200 200 200 200 200 200 200 200 200 200 200 200 000
000 200 200 200 200 200 000 200 200 200 200 200 200 200 200 200 200 200 200 000
000 200 200 200 200 200 000 200 200 200 200 200 200 200 200 200 200 200 200 000
000 200 200 900 200 200 000 200 200 200 200 200 200 200 200 200 200 200 200 000
000 200 200 200 200 200 000 200 200 200 200 200 200 200 200 200 200 200 200 000
000 200 200 200 200 200 000 200 200 200 200 200 200 200 200 200 200 200 200 000
000 000 000 000 000 000 000 000 000 000 000 000 000 000 000 000 000 000 000 000
